11,16
++++++++++++++++
+S+          + +
+ + + ++++++++ +
+ + + +        +
+ + + ++++++++ +
+   +          +
+++++ ++++++++++
+   + +E       +
+ + + ++++++++ +
+ +            +
++++++++++++++++