11,13
+++++++++++++
+   +   +   +
+ + + + + + +
+ + + + + + +
+ + + + + + +
+ + + + + + +
+ + + + + + +
+ + + + + + +
+ + + + + + +
+S+   +   +E+
+++++++++++++