12,19
+++++++++++++++++++
+                 +
+ + + +++ + +++++ +
+ + +++ + + ++ ++ +
+ +   +   + ++    +
+ +++ +++++ +++++++
+  S+     + +E+   +
+ +++++++ + + + + +
+ +       + +   + +
+++++++++++ +++++ +
+                 +
+++++++++++++++++++